Name	Areas of interest
Wil van der Aalst	business process management, process mining, Petri nets
Hal Abelson	intersection of computing and teaching
Serge Abiteboul	database theory
Samson Abramsky	game semantics
Leonard Adleman	RSA, DNA computing
Manindra Agrawal	polynomial-time primality testing
Luis von Ahn	human-based computation
Alfred Aho	compilers book, the 'a' in AWK
Stephen R. Bourne	Bourne shell, portable ALGOL 68C compiler
Kees Koster	ALGOL 68
Lambert Meertens	ALGOL 68, ABC (programming language)
Peter Naur	BNF, ALGOL 60
Guido van Rossum	Python (programming language)
Adriaan van Wijngaarden	Dutch pioneer; ARRA, ALGOL
Dennis E. Wisnosky	Integrated Computer-Aided Manufacturing (ICAM), IDEF
Stephen Wolfram	Mathematica
William Wulf	compilers
Edward Yourdon	Structured Systems Analysis and Design Method
Lotfi Zadeh	fuzzy logic
Arif Zaman	Pseudo-random number generator
Albert Zomaya	Australian pioneer of scheduling in parallel and distributed systems
Konrad Zuse	German pioneer of hardware and software 
